wwwwwwwwwwwwwwwwwwwwwwwwwwwwwwwwwwwwwwwwwwwwwwwwwwwwwwwwwwwwwwwwwwwwwwwwwwwwwwwwwwwwwwwwwwwwwwwwwwwwwwwwwwwww
w...................................c..c...c......@.....c....c..............................................w
w...................................c...c..c..c⌈-----⌉c..c..c..c.............................................w
w..........................................c....c.....c...c.................................................w
w...........................................................................................................w
we.e.e.e..e..e..e..e.e.e..e...e..e.e...e...e..e..e..e..e...e..e..e...e...e...e..e..e..e...e..e..e..e..e.e.e.w
we.e.e.e..e..e..e..e.e.e..e...e..e.e...e...e..e..e..e..e...e..e..e...e...e...e..e..e..e...e..e..e..e..e.e.e.w
wwwwwwwwwwwwwwwwwwwwwwwwwwwwwwwwwwwwwwwwwwwwww......wwwwwwwwwwwwwwwwwwwwwwwwwwwwwwwwwwwwwwwwwwwwwwwwwwwwwwwww
nnnnnnnnnnnnnnnnnnnnnnnnnnnnnnnnnnnnnnnnnnnnnw..pp..wnnnnnnnnnnnnnnnnnnnnnnnnnnnnnnnnnnnnnnnnnnnnnnnnnnnnnnnn
nnnnnnnnnnnnnnnnnnnnnnnnnnnnnnnnnnnnnnnnnnnnnwwwwwwwwnnnnnnnnnnnnnnnnnnnnnnnnnnnnnnnnnnnnnnnnnnnnnnnnnnnnnnnn







